[English Conversation 19](#English-Conversation-19)  
  
## English Conversation 19
[English Conversation 19](https://www.youtube.com/watch?v=Y7DIw84LOEU)   
  
  
__|__
--|--
mirror|зеркало
mirror mirror on the wall|Зеркало, зеркало на стене
who's the fairest of them all|кто самый честный из них всех
hey|Привет
it's the new girl|это новая девушка
hello I'm Elena|привет я елена
come in come in|входи входи
so good to see you Elena|так приятно видеть тебя Елена
I'm Agatha|Я агата
Agatha Johnson|Агата Джонсон
pleased to meet you mrs Johnson|рад познакомиться с вами, миссис Джонсон
welcome to the Johnson family|добро пожаловать в семью Джонсон
um|ммм
I come from Madrid|Я приехал из мадрида
oh no no|о нет нет
welcome to the Johnson family|добро пожаловать в семью Джонсон
my family is in Spain|моя семья в Испании
yes|да
yes I know|Да, я знаю
you must be tired after your long journey|ты должно быть устал после долгого путешествия
sorry I don't understand|извини я не понимаю
my english is not very good|мой английский не очень хорош
you must be tired after your journey|ты должно быть устал после путешествия
yes very tired|да очень устал
very long journey|очень долгое путешествие
yes|да
well now|Ну что ж
let's sit down together|давай сядем вместе
oh|ой
thank you|Спасибо
is everything all right|Все хорошо
everything is all right|все в порядке
mrs Johnson|миссис Джонсон
no you call me Agatha|нет ты зовешь меня агата
ah all right thank you Agatha|ах ладно, спасибо, Агата
you're part of the family now|теперь ты часть семьи
the part of the family|часть семьи
yes|да
my family my brother oh me|моя семья, мой брат, о мне
oh um I have four brothers|о, у меня четыре брата
four brothers|четыре брата
wow wow that's nice|вау вау это мило
they're big boys|они большие мальчики
really what about sisters|действительно как насчет сестер
I also have three sisters|У меня также есть три сестры
oh dear that's too many|о боже, это слишком много
my family is a very big many people|моя семья очень большая, много людей
yes Elena that's nice|да Елена, это мило
you have a big family|у вас большая семья
I have a small family|У меня маленькая семья
now an extra person me|теперь лишний человек я
yes Elena you're one of the family now|да, Елена, ты теперь одна из семьи
thank you Agatha that's nice|спасибо Агата, это мило
well now it's tea time|ну теперь время чая
oh good|о, хорошо
one cup of tea two cups of tea|одна чашка чая две чашки чая
yes that's right|Да все верно
I'll take your bags to your room|Я отнесу твои сумки в твою комнату
then go into the kitchen|затем иди на кухню
what what heavy bags|какие тяжелые сумки
yes many bags|да много сумок
no no it's a heavy heavy bags|нет нет это тяжелые тяжелые сумки
oh yes heavy very heavy bags|о да тяжелые очень тяжелые сумки
okay I'll be right back|хорошо, я скоро вернусь
all right|все в порядке
hmm|хм
here we are|мы здесь
tea four two|чай четыре два
thank you|Спасибо
milk and sugar|молоко и сахар
yes please|Да, пожалуйста
have a biscuit|есть печенье
they're homemade|они домашние
no thank you|нет, спасибо
now you must tell me about yourself|теперь ты должен рассказать мне о себе
your family mom dad|твоя семья мама папа
I have four brothers|У меня четыре брата
and three sisters|и три сестры
well I'm a student and I go to a language school|ну я студент и хожу в языковую школу
to study english|изучать английский
yes|да
my english is not very good|мой английский не очень хорош
no no no no|нет нет Нет Нет
it's quite good|это неплохо
where is the school|где школа
it's near here on exeter avenue|это недалеко здесь, на авеню Эксетера
that's very close|это очень близко
good|хороший
just 10 minutes|всего 10 минут
oh that's easy|о, это легко
perhaps Victor could take you by car|возможно Виктор мог бы отвезти тебя на машине
Victor who's Victor|Виктор, кто такой Виктор
my brother|мой брат
your brother|твой брат
that is a photo of Victor|это фото Виктора
oh|ой
he's a big boy|он большой мальчик
well he's 25.|ну ему 25.
and that is my boyfriend Harold|и это мой парень Гарольд
your boyfriend|твой парень
he works in a bank|он работает в банке
in a bank|в банке
that's my brother Alan|это мой брат Алан
or your brother|или твой брат
he lives in Sydney|он живет в Сиднее
in Australia|в Австралии
yes he loves it|да, он любит это
oh I want to see Australia|о, я хочу увидеть Австралию
me too|я тоже
perhaps one day|возможно однажды
and|а также
and who's that photo|и кто это фото
oh that's just my sister Betty|о, это просто моя сестра Бетти
or your sister|или твоя сестра
she lives near here|она живет рядом здесь
I see her every day|Я вижу ее каждый день
every day|ежедневно
yes|да
we go shopping together|мы вместе ходим по магазинам
you go shopping|ты ходишь по магазинам
she's a very difficult person|она очень сложный человек
but she's your sister|но она твоя сестра
yes|да
she's a very difficult sister|она очень трудная сестра
and this|и это
this is a photo of my mother and my father|это фото моей матери и моего отца
your mother and your father|твоя мать и твой отец
your parents|ваши родители
yes my parents|да мои родители
on their anniversary day|в день их годовщины
sorry I don't understand|извини я не понимаю
on the day that they got married|в тот день, когда они поженились
oh oh yes that anniversary day|о, да, в тот юбилейный день
yes|да
and here is the rest of my family|а вот и остальные члены моей семьи
oh that's interesting|о, это интересно
oh|ой
that's Victor oh he is punctual like always|это Виктор, о, он пунктуален, как всегда
he arrives at home at five o'clock|он приходит домой в пять часов
every day|ежедневно
every day|ежедневно
he lives here|он живет здесь
yes he lives with me|да он живет со мной
oh he lives here|о, он живет здесь
yes with my cat Felix|да с моим котом феликсом
oh your cat Felix|о, твой кот Феликс
and my canary Tweety your canary Twitter|и моя канарейка Твити твит твит канарейка
hello Victor|привет Виктор
come in and meet Elena|заходи и познакомься с Еленой
hello darling|Здравствуй дорогой
hi Agatha|привет Агата
who are you|кто ты
I'm Elena|Я елена
darling this is Elena|дорогая, это Елена
uh Elena|ээ, Елена
hello Elena|привет елена
uh what are you doing here|что ты здесь делаешь
she's staying with us sweetheart|она остается с нами, дорогая
why don't you tell me about these things|почему бы тебе не рассказать мне об этих вещах
oh I do I do I tell you everything darling|о, я делаю, я говорю тебе все, дорогая
Elena this is my gorgeous brother Vic|Елена это мой великолепный брат Вик
he's very handsome very clever and very forgetful|он очень красивый очень умный и очень забывчивый
I'm studying english here|Я изучаю английский здесь
I come from Madrid nice to meet you|Я приехал из Мадрида, приятно познакомиться
studying english|изучая английский
yes I want to speak a good english|да я хочу говорить на хорошем английском
and become a tourist guide|и стать туристическим гидом
lovely|прекрасный
lovely girl|милая девушка
where|где
where are you studying|где вы учитесь
at the queen school on exeter avenue|в школе королевы на авеню Эксетер
you know it|ты это знаешь
do I know it Agatha|я знаю это Агата
do I know the school|я знаю школу
of course darling|конечно, дорогая
of course he does|конечно он делает
of course I do|конечно, я делаю
silly me|я такой глупый
silly you|ты глупый
silly you|ты глупый
well|Что ж
I think that we are going to have a wonderful time with Elena staying here|Я думаю, что мы прекрасно проведем время с Еленой, остановившись здесь
yes a wonderful time|да чудесное время
thank you|Спасибо
how long are you going to be in London|как долго ты собираешься быть в Лондоне
that's right|вот так
get to know each other and I'll go start dinner|узнайте друг друга, и я пойду начать ужин
can I help you Agatha|могу ли я помочь тебе Агата
no sweet girl you stay right where you are|Нет, милая девушка, оставайся там, где стоишь
all right|все в порядке
when did you arrive|когда ты прибыл
uh today and you'll be staying with us until you go back to Spain|эээ сегодня, и ты останешься с нами, пока не вернешься в Испанию
when|когда
um I go back to Madrid after my english course and my language course is eight weeks|эм, я возвращаюсь в Мадрид после курса английского, и мой языковой курс длится восемь недель
love is in the air|любовь витает в воздухе
love is in the air|любовь витает в воздухе
I'm sorry my sisteris a little eccentric|Извини, моя сестра немного эксцентричная
your sister is very nice|твоя сестра очень милая
tell me tell me about your family Elena|расскажи мне расскажи мне о своей семье елена
I have many uh sister and brothers|У меня много сестер и братьев
are you the oldest|ты самый старший?
uh|ээ
no I have two brothers and one sister|нет у меня есть два брата и одна сестра
who are older|кто старше
older older than you|старше тебя
yes and my my mother is Carmen and my father is Fernando|да и моя мама - Кармен, а мой отец - Фернандо
and this is your first time away from Madrid|и это ваш первый раз вдали от Мадрида
yes um I'm happy uh to be in London but also I'm a little sad|да, я рад быть в Лондоне, но мне немного грустно
uh you miss|ты скучаешь
uh you miss your big family|ты скучаешь по своей большой семье
yes but|Да, но
but you are very kind and you are very nice|но ты очень добрый и очень милый
thank you and|Спасибо и
what does your father do back in Madrid|чем занимается твой отец в Мадриде
what's his job|кем он работает
he makes this and and this um|он делает это и это эм
um oh he makes|эм ой он делает
he makes furniture|он делает мебель
yes yeah|да да
and your mother does she work|а твоя мама работает
my mother works very hard in the house|моя мама очень много работает по дому
cooking washing cleaning|готовка мытье чистка
your mother is a housewife|твоя мама - домохозяйка
a housewife|домохозяйка
so how are you getting along|так как у тебя дела
uh just fine thanks Agatha|просто отлично спасибо, Агата
very fine thank you|очень хорошо спасибо
wonderful|замечательно
now come and help me set the table|теперь иди и помоги мне накрыть на стол
okay|Ладно
can I help|могу ли я помочь
all right yes please|хорошо да пожалуйста
set the table deare|накрыть на стол дорогой
set the table|накрывать на стол
I'll help you|я тебе помогу
oh|ой
that's a good boy|это хороший мальчик
the plates|тарелки
is your boyfriend Harold eating with us|твой парень Гарольд ест с нами?
no Harold is in Oxford|нет Гарольда в Оксфорде
Harold's bank has an office in Oxford|У банка Гарольда есть офис в Оксфорде
oh our knives and forks|о наши ножи и вилки
knife fork and spoon|нож, вилка и ложка
is the table set|стол накрыт
uh yes I guess|да я думаю
good sit down please|хорошо сядь пожалуйста
dinner is ready|обед готов
are we having dinner now|мы сейчас обедаем?
why of course dear|почему конечно дорогой
what are we having|что у нас есть
we are having soup and salad do you like chicken soup Elena|у нас есть суп и салат ты любишь куриный суп Елена
yes thank you|да спасибо
oh please put the napkins on the table Victor|ой пожалуйста положите салфетки на стол Виктор
oh sorry|ой, извини
um here they are|эм вот они
my silly Victor he forgets everything|мой глупый Виктор он все забывает
everything|все
here is your soup help yourselves to the bread|вот ваш суп угощайтесь хлебом
thank you Agatha|спасибо Агата
you're welcome my dear|всегда пожалуйста, дорогой
it's so nice to have you here|так приятно видеть тебя здесь
yes it's it's nice to have you here|да, это приятно, что ты здесь
thank you|Спасибо
that's very kind|Это очень любезно с
nonsense|ерунда
now let's eat|теперь давайте поесть
how's your soup|как твой суп
it's delicious|это вкусно
what's wrong dear|что случилось дорогой
don't you like it|тебе это не нравится
oh well|Ну что ж
you don't feel well|ты плохо себя чувствуешь
no I'm sorry it is a bit early for me|нет, извини, для меня еще рано
I am not really hungry|Я не очень голоден
not hungry|не голоден
um what time does your family eat dinner back in Spain|эм, во сколько ваша семья обедает в Испании
uh we eat dinner at 10 o'clock at home|мы ужинаем в 10 часов дома
wow|Вау
imagine that|представь это
we're usually in bed before midnight|мы обычно ложимся до полуночи
Elena darling you must forgive our strange|Елена дорогая, ты должен простить нашу странную
english habits|английские привычки
no it is all a bit strange for me now|нет, для меня сейчас все немного странно
my poor dear|моя бедная дорогая
you must be exhausted|ты должно быть устал
maybe you should go to bed uh soon Elena|Может тебе поскорее лечь спать, Елена
yes please uh I'm sorry|да, пожалуйста, прости
no|нет
don't worry|не волнуйся
you go in and sleep|иди и спи
thank you both|Спасибо вам обоим
good night Elena|спокойной ночи елена
night|ночь
good night|спокойной ночи
sleep well dear|спать спокойно дорогой
not again Agatha|не снова Агата
don't do this to me again|не делай этого со мной снова
why my darling brother|почему мой дорогой брат
what are you talking about|О чем ты говоришь
oh|ой
good morning|доброе утро
you're up uh early|ты рано встал
yes I'm looking for um for my|да, я ищу для своего
um for your keys|эм для твоих ключей
yeah thank you|да спасибо
thank you Victor|спасибо Виктор
um do your classes start today|Уроки начинаются сегодня
no I start classes on wednesday|нет, я начинаю занятия в среду
I'm looking for a job today|Я ищу работу сегодня
oh um it's a good idea to get the the paper early|о, это хорошая идея получить газету пораньше
can I can I make you some tea|могу я приготовить тебе чаю
do you have coffee|у тебя есть кофе
sorry I'm not sure if we have any coffee|извини, я не уверен, есть ли у нас кофе
let me have a look|дай мне взглянуть
darling good morning|дорогая доброе утро
oh good morning Agatha|о, доброе утро, Агата
what a clever girl|какая умная девушка
you're doing morning exercises|ты делаешь утреннюю зарядку
uh yes|ах да
yes|да
did you sleep well|хорошо ли спалось
very well|отлично
I'm sorry no coffee maybe we should add it to the shopping list|Извините, кофе нет, может, стоит добавить его в список покупок
oh yes yes|о да да
tell me what you need|скажите, что вам нужно
I'm going shopping with my sister betty|Я иду по магазинам с сестрой Бетти
oh coffee would be nice|о, кофе было бы неплохо
well what are your plans for today sweetheart|хорошо, каковы твои планы на сегодня, дорогая
oh she's hunting|о, она охотится
she's looking for a part-time job|она ищет подработку
how industrious|как трудолюбивый
well a pretty girl like you will have no trouble finding a job|Что ж, у такой красивой девушки, как ты, не будет проблем с поиском работы
here's the paper|вот бумага
thanks|Благодарность
and look there's one|и посмотри, есть один
it's uh here in kensington|это здесь, в Кенсингтоне
a video store on the high street|видеомагазин на главной улице
oh young person with excellent communication skills|о молодой человек с отличными коммуникативными навыками
that's perfect|это идеально
yeah and afternoon shifts thursdays saturdays and sundays|да и дневные смены по четвергам, субботам и воскресеньям
uh where is the high street|а где главная улица
just make a left at the top of our road onto hornton|просто поверните налево в верхней части нашей дороги на Хорнтон
and then make another left onto the ligh street|а затем поверните налево на светлую улицу
the store is on your right|магазин справа от вас
next to the tube station|рядом со станцией метро
uh the tube|эээ трубка
um I'll walk you up there|эм, я провожу тебя туда
okay|Ладно
thank you that is very kind of you|спасибо, что вы очень любезны
nonsense my brother's a gentleman|чушь мой брат джентльмен
um go get ready and I'll meet you downstairs in 15 minutes okay|Пойди, готовься, я встречу тебя внизу через 15 минут, ладно
okay|Ладно
well good luck my dear|что ж, удачи моя дорогая
have a nice day|хорошего дня
thanks you too Agatha|спасибо тебе тоже агата
I'll see you in a little while|Увидимся через некоторое время
bye bye bye|пока пока пока
hello hello|Привет привет
how was your day|как прошел день
fabulous fabulous|сказочный сказочный
fabulous is excellent|сказочно отлично
I had a fabulous day too|У меня тоже был сказочный день
uh going shopping|иду за покупками
yes|да
Betty and I shopped all day|Бетти и я весь день ходили по магазинам
look at my new nail polish|посмотри на мой новый лак для ногтей
and this blouse is new|и эта блузка новая
it looks divinebon me don't you think|это выглядит божественно, мне тебе не кажется
it's very beautiful|это очень красиво
and I have a skirt to go with it and a pair of boots|и у меня есть юбка и пара сапог
lovely|прекрасный
of course betty is jealous|конечно Бетти ревнует
she says I spend too much money on clothes|она говорит, что я трачу слишком много денег на одежду
hi girls|Привет девчонки
it's getting cold out there|там становится холодно
I think it's going to rain|Я думаю пойдет дождь
oh I hope not|о, я надеюсь, что нет
had a productive day|был продуктивный день
Agatha|Агата
yes delightful|да восхитительно
and how was your interview Elena|а как прошло ваше интервью Елена
uh|ээ
productive|продуктивный
I start work on thursday after the school|Я начинаю работу в четверг после школы
congratulations|поздравления
well done darling|молодец дорогой
and um when do you finish work|и когда ты закончишь работу
um my shifts are from three to seven|эм мои смены с трех до семи
and what will you do at the store|и что ты будешь делать в магазине
I put the videos on their shelves|Я кладу видео на их полки
and I find information on the computer for customers|и я нахожу информацию на компьютере для клиентов
I love movies|Я люблю фильмы
do you know what my favorite movie is|ты знаешь, какой мой любимый фильм
no what is your favorite movie|нет какой твой любимый фильм
butterfield eight well any movie with liz taylor|баттерфилд восемь колодцев любой фильм с лиз тейлор
um I don't know it A|эм я не знаю это
gatha watches it a lot|Гата много смотрит на это
betty has the video|У Бетти есть видео
oh I would like to see the movie too|о, я бы тоже хотел посмотреть фильм
you will love it|ты полюбишь это
liz|Лиз
wears the most brilliant clothes|носит самую блестящую одежду
and lawrence harvey|и Лоуренс Харви
what a man|какой человек
do you like it Victor|тебе нравится Виктор
it's a bit old for me|для меня это немного устарело
I prefer science fiction and fantasy stories|Я предпочитаю научную фантастику и фантастические рассказы
when I finish my course|когда я закончу свой курс
I'd like to try painting sets for films|Хочу попробовать наборы для рисования к фильмам
oh that sounds exciting|о, это звучит захватывающе
speaking of clothing|говоря об одежде
do you have a warm coat Elena|у тебя есть теплое пальто Елена
this is my coat|это мое пальто
oh you will die of cold in that coat|о, ты умрешь от холода в этом пальто
you will really need a warmer coat soon Elena|тебе очень скоро понадобится теплая шуба Елена
it gets very cold in London|в Лондоне становится очень холодно
not like sunny barcelona|не как солнечная барселона
Madrid|Мадрид
um we might get some some snow at christmas|у нас может быть снег на рождество
no no that will|нет нет это будет
be a new experience for you|быть новым опытом для вас
yes|да
oh wonderful|о, замечательно
you don't have school tomorrow|у тебя завтра нет школы
let's go shopping|пойдем по магазинам
okay let's go shopping|хорошо, пойдем по магазинам
  
  