[1000 English conversation phrases that seem easy but are not](#1000-English-conversation-phrases-that-seem-easy-but-are-not)  
  
## 1000 English conversation phrases that seem easy but are not
[1000 English conversation phrases that seem easy but are not](https://www.youtube.com/watch?v=g9m7ezjEsMA)   
  
  
__|__
--|--
we sat down face to face|мы сели лицом к лицу
you can go to the station by bus|можно доехать до вокзала на автобусе
winter in New York can be very cold|зима в Нью-Йорке может быть очень холодной
I nearly made a mistake|Я чуть не ошибся
we live near a big library|мы живем рядом с большой библиотекой
she hung the calendar on the wall|она повесила календарь на стену
it took five minutes to get to the station|дорога до станции заняла пять минут
come again tomorrow|приходи завтра снова
she plays the guitar|она играет на гитаре
he does not smoke|он не курит
the weather is usually hot in July|погода обычно жаркая в июле
I don't like this jacket|Мне не нравится эта куртка
you look sick|ты выглядишь больным
shut your mouth|закрой свой рот
these aren't my books|это не мои книги
have you finished reading the novel|вы дочитали роман?
who will look after your dog|кто будет присматривать за вашей собакой
he broke the world record|он побил мировой рекорд
aren't you thirsty|ты не хочешь пить?
he wants to see us again|он хочет увидеть нас снова
those books are theirs|эти книги их
wash your face|умойся
I wonder if she will marry him|Интересно, выйдет ли она за него замуж
ask him where he parked his car|спроси его, где он припарковал свою машину
my father smokes|мой отец курит
I'm from Tokyo|Я из токио
he played tennis|он играл в теннис
can you do this problem|ты можешь решить эту проблему
she runs faster than I do|она бежит быстрее, чем я
I'm just beginning|Я только начинаю
were you with anyone|ты был с кем-нибудь
he cheated on the biology exam|он обманул на экзамене по биологии
were you busy yesterday|ты был занят вчера
I wish I could|Мне бы хотелось, чтобы я мог
I have an earache|У меня болит ухо
I go to my father's place twice a year|Я хожу к отцу два раза в год
he promised to come but he didn't come|он обещал прийти, но он не пришел
this is a book|это книга
they forgot to lock the door|они забыли запереть дверь
take care|Береги себя
he doesn't seem to be an American|он не кажется американцем
I would like you to come with me|Я бы хотел, чтобы ты пошел со мной
I will be back at half past six|Я вернусь в половине седьмого
he didn't say a word|он не сказал ни слова
I love this picture|Я люблю эту картину
I saw him just now|Я видел его только что
the man robbed him of all his money|мужчина украл у него все деньги
what are your strong points|каковы твои сильные стороны
there is a pair of scissors on the desk|на столе есть ножницы
did you have a good time yesterday|ты хорошо провел время вчера
somebody is playing the piano|кто-то играет на пианино
who is that woman|кто эта женщина
I know none of them|Я никого из них не знаю
you'd better not go|тебе лучше не идти
may I borrow your dictionary|могу я одолжить твой словарь
she kicked the door|она пнула дверь
my hobby is collecting coins|мое хобби - собирать монеты
he was robbed of all his money|у него украли все его деньги
we usually have lunch at noon|мы обычно обедаем в полдень
does someone here speak Japanese|здесь кто-то говорит по-японски?
this is my daughter|это моя дочь
I got married eight years ago|Я женился восемь лет назад
I slept nine hours|Я проспал девять часов
will you stay at home|ты останешься дома
it's a long way from here to school|отсюда до школы далеко
let's open the window|давай откроем окно
my sister takes piano lessons twice a week|моя сестра берет уроки игры на фортепиано два раза в неделю
she doesn't understand me either|она меня тоже не понимает
why don't you come to the movies with me|почему бы тебе не пойти со мной в кино
his answer is different from mine|его ответ отличается от моего
I will come with you|я пойду с тобой
there is an orange on the table|на столе есть апельсин
I've got to go now|я должен идти сейчас
where have you been this week|где ты был на этой неделе
take anything you want|бери все, что хочешь
where is the entrance to the museum|где вход в музей
that's what we want to know|это то, что мы хотим знать
whose shoes are these|Чья это обувь
he asked her if she knew him|он спросил ее, знает ли она его
she likes oranges|она любит апельсины
here's some water|вот немного воды
I'm from Singapore|Я из сингапура
he is eating|он ест
how long is he going to stay in Japan|как долго он собирается оставаться в Японии
she left me a note|она оставила мне записку
who painted this picture|кто нарисовал эту картину
I'm very busy|Я очень занят
I lost my watch|Я потерял часы
the boy acknowledged having lied|мальчик признал, что солгал
this newspaper is free|эта газета бесплатная
I usually take a bath before going to bed|Я обычно принимаю ванну перед сном
my brother sends you his regards|мой брат передает вам привет
they were listening to the radio|они слушали радио
I often see him|Я часто вижу его
he was just behind me|он был прямо позади меня
he is her friend|он ее друг
what happened|что произошло
I can peel an Apple|Я могу очистить яблоко
I can peel an Apple|Я могу очистить яблоко
I can peel an apple|Я могу очистить яблоко
there are five pencils here|здесь пять карандашей
this is a little gift for you|это маленький подарок для тебя
I went to Boston by train|Я поехал в бостон на поезде
I want to learn how to swim|Я хочу научиться плавать
I can't do anything else|Я ничего не могу сделать
it almost never rains here|здесь почти никогда не идет дождь
do you know the reason|ты знаешь причину
I wish our classroom were air-conditioned|Я бы хотел, чтобы в нашем классе был кондиционер
don't worry about that|не беспокойся об этом
we had a very hot summer this year|у нас было очень жаркое лето в этом году
my sister is having a baby in June|у моей сестры в июне будет ребенок
the car is very fast|машина очень быстрая
he got up earlier than usual|он встал раньше обычного
the boy tried moving the heavy sofa|мальчик попытался переместить тяжелый диван
I want to eat something|я хочу съесть что-нибудь
he was very happy|он был очень счастлив
the girls began to laugh|девочки начали смеяться
I'm sorry I dropped my knife|Извини, что уронил нож
please pass me the butter|пожалуйста, передай мне масло
we saw clouds above the mountain|мы видели облака над горой
my telephone is out of order|мой телефон не работает
the fruit went bad|фрукт испортился
that boy is running|этот мальчик бежит
I'm waiting for the bus|Я жду автобус
he was patient|он был терпеливым
the boy ran away|мальчик убежал
do you go to school by bus|ты ездишь в школу на автобусе
he couldn't understand the sentence|он не мог понять предложение
add a little sugar and cream|добавить немного сахара и сливок
I go home early every day|Я хожу домой рано каждый день
I must return home within a week|Я должен вернуться домой в течение недели
how far is it from here|как далеко это от сюда
he is still young|он еще молод
it's up to you to decide|тебе решать
can I use this bike|могу я использовать этот велосипед
English is difficult to learn|Английский трудно выучить
I went for a walk in the park|Я пошла гулять в парк
the door is open now|дверь открыта сейчас
for here or to go|здесь или на вынос
what are they made of|из чего они сделаны
everybody likes him|он всем нравится
get me a chair please|принеси мне стул, пожалуйста
I'm glad to see you|Я рад тебя видеть
I have an allergy to milk|У меня аллергия на молоко
I'm so happy|Я очень счастлив
how long have you known her|как долго вы знали ее
I must visit my friend in the hospital|Я должен навестить своего друга в больнице
they made me go there|они заставили меня пойти туда
I know she is sleeping|Я знаю она спит
is there a curfew|есть комендантский час?
he is very depressed|он очень подавлен
not all children like apples|не все дети любят яблоки
this book isn't interesting at all|эта книга совсем не интересна
he is watching TV|он смотрит телевизор
would you please stop talking|не могли бы вы прекратить говорить
ask him when the next plane leaves|спроси его, когда улетит следующий самолет
I don't like cheese very much|Я не очень люблю сыр
what did you talk about|о чем ты говорил
I hope today's ball game won't be canceled|Я надеюсь, что сегодняшняя игра с мячом не будет отменена
where can I rent a car|Где можно взять машину напрокат
the weather forecast is not necessarily reliable|прогноз погоды не обязательно надежен
my joints ache|мои суставы болят
I wish I could fly like a bird|Хотел бы я летать как птица
she is a wealthy woman|она богатая женщина
will you please call me this evening|пожалуйста, позвоните мне сегодня вечером
my mother cut the cake|моя мама разрезала торт
what time do we leave tomorrow|в какое время мы уезжаем завтра
my father died of lung cancer|мой отец умер от рака легких
what's your daughter's name|как зовут твою дочь
you may give the book to whoever one set|Вы можете отдать книгу кому угодно
she lives quite close by|она живет довольно близко
were you playing tennis yesterday morning|ты играл в теннис вчера утром?
is he your teacher|он твой учитель
I'm sorry to hear that|Мне очень жаль это слышать
we arrived at the office on time|мы прибыли в офис вовремя
he is afraid of becoming sick|он боится заболеть
I'd like to have a coffee|Я бы хотел кофе
his hands were empty|его руки были пусты
you will never realize what I went through|ты никогда не поймешь, через что я прошел
is it still raining|Все еще идет дождь
he began running|он начал бежать
will you have another cup of milk|ты выпьешь еще чашку молока?
I have to comb my hair|Мне нужно причесаться
I don't like this sweater|Мне не нравится этот свитер
all of my friends like soccer|все мои друзья любят футбол
my house is near the station|мой дом возле вокзала
do it right now before you forget|сделай это прямо сейчас, пока не забыл
I will introduce her husband to you|Я познакомлю ее с мужем
I'll be busy tomorrow|Я буду занят завтра
this flower is beautiful isn't it|этот цветок прекрасен, не так ли
our refrigerator is out of order|наш холодильник вышел из строя
he was married to her sister|он был женат на ее сестре
he has no children|у него нет детей
don't let me down|не подведи меня
I wonder if the plane will arrive on time|Интересно, прилетит ли самолет вовремя
she kept him waiting for a long time|она заставила его долго ждать
what did you eat for breakfast|что вы ели на завтрак
my father insisted that we should go|мой отец настоял на том, чтобы мы пошли
by the way are you free this afternoon|кстати, ты свободен сегодня днем?
he often goes to Tokyo|он часто ходит в Токио
can you speak French|Вы говорите по-французски
she has flowers in her hand|у нее в руке цветы
my stomach is growling|мой живот урчит
this is a very old book|это очень старая книга
here is my bicycle|вот мой велосипед
I want someone to talk to|Я хочу с кем поговорить
some boys came into the classroom|некоторые мальчики пришли в класс
he plays soccer|он играет в футбол
he rang the doorbell|он позвонил в дверь
I have been ill in bed since last Friday|Я болею в постели с прошлой пятницы
my father was busy|мой отец был занят
I learned a lot from him|Я многому у него научился
he got angry|он разозлился
she turned down my offer|она отклонила мое предложение
is this ball yours or hers|это твой мяч?
please take one|пожалуйста возьми один
put that in writing|записать это
they have their own troubles|у них свои проблемы
the twins look exactly alike|близнецы выглядят совершенно одинаково
he died recently|он умер недавно
it smells delicious|пахнет вкусно
beautiful day isn't it|прекрасный день, не так ли
I'd like to see the doctor soon|Я бы хотела скорее к врачу
she can't swim|она не умеет плавать
I'll give you a prescription|Я дам тебе рецепт
tomorrow is Mother's Day|завтра день матери
the girl resembled her mother|девочка была похожа на свою мать
I can't do it|Я не могу этого сделать
we're going to have a test today|сегодня у нас будет тест
I've lost a little weight|Я немного похудела
I'll come back|я приду снова
there is no smoke without fire|нет дыма без огня
she can play the piano very well|она очень хорошо умеет играть на пианино
anybody can do that|любой может это сделать
please pass me the sugar|пожалуйста, передай мне сахар
do they sell notebooks at that store|они продают записные книжки в этом магазине?
you will soon adapt yourself to this new life|ты скоро приспособишься к этой новой жизни
may I help you|Я могу вам чем-нибудь помочь
I can't sleep|Я не могу спать
Paris is the capital of France|Париж - столица Франции
he is very young|он очень молод
don't leave the window open|не оставляй окно открытым
is the dog swimming|собака плавает?
we would like to stay here tonight|мы хотели бы остаться здесь сегодня вечером
have you ever seen a panda|вы когда-нибудь видели панду
which company do you work for|в какой компании ты работаешь
he was at home|он был дома
you can do it can't you|ты можешь сделать это не так ли
why did you do that|зачем ты это сделал
please turn on the TV|пожалуйста, включите телевизор
he is always with me|он всегда со мной
I remember seeing her somewhere|Я помню, как видел ее где-то
I waited for her for a long time|Я ждал ее очень долго
this cake is sweet|этот торт сладкий
have you eaten lunch yet|ты уже обедал?
stay home so that you can answer the phone|оставайся дома, чтобы ты мог ответить на звонок
whose is this book|чья это книга
he comes round once a week|он приходит раз в неделю
I went there yesterday|Я был там вчера
my mother has four brothers|у моей мамы четыре брата
whose friend is he|чей он друг
why is it so hot|почему так жарко
she is a very good teacher|она очень хороший учитель
look at the map on page 62|посмотрите карту на странице 62
many people were deceived by the advertisement|многие люди были обмануты рекламой
it was raining yesterday|вчера шел дождь
they have English lessons three times a week|у них уроки английского языка три раза в неделю
no matter where you go I'll follow you|куда бы ты ни пошел, я пойду за тобой
I also like cake|Я тоже люблю торт
it's on the eighth floor|это на восьмом этаже
do you like black cats|тебе нравятся черные кошки
he became rich|он стал богатым
we didn't know what to do|мы не знали что делать
time is the most precious thing|время самое дорогое
the pain is getting worse|боль усиливается
he walked home|он шел домой
I don't like it at all|Мне это совсем не нравится
he has a very expensive watch|у него очень дорогие часы
I forgot to lock the storeroom|Я забыл запереть кладовую
I'm not busy|Я не занят
what time is it|который сейчас час
do you mind if I open the window|не возражаешь, если я открою окно
I have an appointment with him at 6:00|У меня назначена встреча с ним в 6:00
don't make the same mistake again|не делай ту же ошибку снова
I put it in the drawer|Я положил это в ящик
the new museum is worth visiting|новый музей стоит посетить
I would like to go fishing if possible|Я бы хотел по возможности пойти на рыбалку
he made an apology|он принес извинения
I play video games|я играю в видеоигры
I can't stand up|Я не могу встать
I caught three fish yesterday|Я вчера поймал три рыбы
I bought it|я купил это
elephants live in Asia and Africa|слоны живут в Азии и Африке
I want a good dictionary|Я хочу хороший словарь
staying home isn't fun|оставаться дома не весело
could you drive more slowly|не могли бы вы водить помедленнее
eat everything|есть все
fruits have seeds in them|во фруктах есть семена
he took off his glasses|он снял очки
it's up to you|тебе решать
I returned home by train|Я вернулся домой поездом
he is introverted|он замкнутый
he feels very happy|он чувствует себя очень счастливым
I'm easygoing|Я спокойный
I am going to start|Я собираюсь начать
there are many words that I don't understand|есть много слов, которые я не понимаю
where will you have lunch today|где ты будешь обедать сегодня
physics is my favorite subject|физика мой любимый предмет
our project failed|наш проект провалился
he is still here|он все еще здесь
my idea is quite different from yours|моя идея сильно отличается от вашей
can I borrow your umbrella|могу я одолжить твой зонт
there is no hope of success|нет надежды на успех
thank you in advance|заранее спасибо
my wife will be glad to see you too|моя жена тоже будет рада видеть тебя
did you call your friend in Canada|ты звонил своему другу в Канаду?
have you seen my glasses anywhere|ты где-нибудь видел мои очки?
please do it quickly|пожалуйста, сделай это быстро
don't be afraid to make mistakes when speaking English|не бойтесь ошибаться, говоря по-английски
are you working|вы работаете
this box is full of books|эта коробка полна книг
we were in a hurry|мы торопились
they have lived in this town for 10 years|они жили в этом городе 10 лет
I will never tell|Я никогда не скажу
he is the captain of the team|он капитан команды
I want to close my account|Я хочу закрыть свой аккаунт
don't be taken in by his words|не поддавайся его словам
it's not so far|это не так далеко
he married my sister|он женился на моей сестре
I will accompany you|Я буду сопровождать тебя
what does she have|что у нее есть
make a copy of this report|сделайте копию этого отчета
water freezes at zero degrees centigrade|вода замерзает при нулевой температуре
he returned from Holland in June|он вернулся из Голландии в июне
our teacher speaks French as well as English|наш учитель говорит на французском, а также на английском
this is too easy for him|это слишком легко для него
can I help|могу ли я помочь
my uncle has made me what I am today|мой дядя сделал меня тем, кем я являюсь сегодня
your dreams have come true|твои мечты сбылись
how long did they live in England|как долго они жили в Англии
my family goes to Italy every year|моя семья уезжает в Италию каждый год
you really shouldn't use pirated software|вам действительно не следует использовать пиратское программное обеспечение
he is stronger than I am|он сильнее меня
what are you going to have|что у тебя будет
I helped him yesterday|Я помог ему вчера
what time did you arrive there|во сколько вы приехали
I bought a few eggs and a little milk|Я купил несколько яиц и немного молока
I usually eat out|Я обычно ем вне дома
this is the book that I told you about|это книга, о которой я тебе говорил
don't tell lies|не лги
I prefer meat to fish|Я предпочитаю мясо рыбе
may I go to the toilet|можно я в туалет
What did he say|Что он сказал
could you bring me a pillow and blanket please|не могли бы вы принести мне подушку и одеяло, пожалуйста
you're a genius|ты гений
Tom likes swimming|Том любит плавать
I received your letter|я получила твое письмо
he has his own car|у него есть собственная машина
this book isn't worth reading|эту книгу не стоит читать
where did you see the woman|где ты видел женщину
he's two years older than Mary is|он на два года старше Мэри
tom is eager to buy a new car|Том хочет купить новую машину
would you lend me your pen|одолжите ли вы мне свою ручку
I like to travel by myself|Я люблю путешествовать одна
I like to travel by myself|Я люблю путешествовать одна
I'd like to travel by myself|Я бы хотел путешествовать один
I'll be with you in a second|Я буду с тобой через секунду
this house needs painting|этот дом нуждается в покраске
who broke the vase|кто разбил вазу
my father made me wash the car|мой отец заставил меня мыть машину
where will we eat|где мы будем есть
did you hear someone ring the doorbell|Вы слышали, как кто-то звонил в дверной звонок?
I turned the doorknob|Я повернул дверную ручку
you look very tired|ты выглядишь очень усталым
a sponge absorbs water|губка впитывает воду
let me see it|позволь мне увидеть это
I want to drive|Я хочу водить
this book seemed interesting|эта книга показалась интересной
I want you to tell me the truth|Я хочу, чтобы ты сказал мне правду
did she come with him|она пошла с ним
I left my dictionary downstairs|Я оставил свой словарь внизу
it was so dark that they could hardly see|было так темно, что они почти не могли видеть
the island is warm all year|на острове тепло круглый год
count me in|считать меня в
if only I could speak English|если бы я только мог говорить по-английски
we played soccer yesterday|мы играли в футбол вчера
I play tennis|я играю в теннис
he came to see me|он пришел ко мне
he is good at driving|он хорошо водит
which is mine|который мой
what do you mean|что вы имеете в виду
I need a new bicycle|Мне нужен новый велосипед
there's no evidence|нет никаких доказательств
talking in the library is not allowed|разговаривать в библиотеке запрещено
does she speak French|она говорит по-французски
do you know how to play chess|ты умеешь играть в шахматы?
this room doesn't get a lot of Sun|в этой комнате не так много солнца
is he a teacher|он учитель
I'm very glad to see you|Я очень рада тебя видеть
you and I have something in common|у нас с тобой есть что-то общее
he is a student at a high school|он учится в средней школе
by the way where are you from|кстати откуда ты
I am pretty sure|я весьма уверен
I saw him jump|Я видел, как он прыгнул
my brother was killed in a traffic accident|мой брат погиб в дорожно-транспортном происшествии
the supermarket opens at 10 o clock|супермаркет открывается в 10 часов
take off your coat and make yourself at home|сними пальто и будь как дома
I called for help|Я звал на помощь
he was sitting on a bench|он сидел на скамейке
be quiet or the baby will wake up|молчи или ребенок проснется
the boy is kind|мальчик добрый
he is very a dangerous man|он очень опасный человек
he's always short of money|у него всегда не хватает денег
I'll tell you a secret|Я открою тебе секрет
I don't know French|Я не знаю французского
whose room is this|чья это комната
he can drive a car|он может водить машину
he gave up smoking two years ago|он бросил курить два года назад
don't stop here|не останавливайся здесь
he seemed to have been very happy|он казался очень счастливым
show me another camera|покажи мне другую камеру
he is a clever boy|он умный мальчик
any day will do except Monday|подойдет любой день кроме понедельника
I am terribly hungry|Я ужасно голоден
never tell a lie|никогда не лги
she refused his proposal|она отказалась от его предложения
it looks like snow|похоже на снег
his aunt looks young|его тетя выглядит молодо
take off your socks please|сними носки пожалуйста
the printer needs paper|принтеру нужна бумага
it's awfully hot today|сегодня ужасно жарко
do you see him often|ты видишь его часто?
give me a hand with this bag|дайте мне руку с этой сумкой
the girl resembles her mother|девочка похожа на свою мать
I think we had better wait another 30 minutes|Я думаю, нам лучше подождать еще 30 минут
time flies like an arrow|Время летит как стрела
I used to take a walk every morning|Я гулял каждое утро
I'm free now|я сейчас свободен
take it easy|не принимайте это близко к сердцу
what's your name|как твое имя
he has broken the record|он побил рекорд
cheese is made from milk|сыр делают из молока
the work is now in progress|сейчас работа ведется
come to my house this afternoon|приходи ко мне домой сегодня днем
it rained hard all day|весь день шел сильный дождь
this house has two bathrooms|в этом доме две ванные комнаты
children should play outside|дети должны играть на улице
do you want to sit down|ты хочешь сесть?
he still writes to me from time to time|он все еще пишет мне время от времени
I'll miss you|Я буду скучать по тебе
he knows a lot of people|он знает много людей
where should we go|Куда мы пойдем
you are absolutely right|ты абсолютно прав
they are my classmates|они мои одноклассники
read after me|читай после меня
what's in the box|что в коробке
I'm afraid it will rain|Боюсь пойдет дождь
I can't help it|Я ничего не могу поделать
I am tired of reading|Я устал читать
it's the 3rd of October|это 3 октября
I had breakfast at 7:30|Я завтракал в 7:30
every door in the house is locked|каждая дверь в доме заперта
once more please|еще раз пожалуйста
excuse me but may I open the window|извините, но могу я открыть окно
I don't like to speak in public|Я не люблю говорить публично
what did the doctor say|что сказал доктор
I've caught a cold|Я простудился
have you ever returned home before 7:00|Вы когда-нибудь возвращались домой до 7:00
there is a page missing|отсутствует страница
I had hoped to save more money|Я надеялся сэкономить больше денег
the building was built in 1960|здание 1960 года постройки
we reached London at midnight|мы прибыли в Лондон в полночь
I'm coming|Я иду
who broke this window|кто разбил это окно
she stayed at the hotel for several days|она оставалась в отеле несколько дней
I like skiing very much|Я очень люблю кататься на лыжах
she has just turned 12|ей только что исполнилось 12
it is difficult for me to answer the question|мне сложно ответить на вопрос
I got my right leg hurt in the accident|Я получил травму правой ноги в аварии
it is likely to rain today|сегодня вероятно дождь
what is she like|на что она похожа
his temperature is normal|его температура в норме
you'll get well soon|ты скоро поправишься
the Netherlands is a small country|Нидерланды - маленькая страна
I met nobody on my way home|Я никого не встретил по дороге домой
I don't know whether to turn left or right|Я не знаю, повернуть налево или направо
I hope my dream will come true|Надеюсь моя мечта сбудется
my wife is preparing dinner right now|моя жена готовит ужин прямо сейчас
I arrived just in time for the plane|Я прилетел как раз к самолету
would you please write your name here|не могли бы вы написать здесь свое имя
the chili burnt my tongue|перец чили обжег мой язык
we've already done our work|мы уже сделали свою работу
this makes no sense|это не имеет никакого смысла
why are you so angry with him|почему ты так зол на него
choose between these two|выбирай между этими двумя
have you ever been to Canada|Ты когда-нибудь был в Канаде
they never tell a lie|они никогда не лгут
you know quite a lot about sumo|ты довольно много знаешь о сумо
he accepted the job|он принял работу
our seats available|наши места доступны
why are you so late|Почему ты так поздно
I heard someone calling my name|Я слышал, как кто-то зовет меня по имени
black cloth absorbs light|черная ткань поглощает свет
I want to go to America someday|Я хочу когда-нибудь поехать в америку
you can study here|ты можешь учиться здесь
what time will dinner be served|в какое время будет подан ужин
we are the first to arrive|мы первые прибыли
leave me alone please|оставьте меня одного, пожалуйста
my mother is two years younger than my father|моя мама на два года моложе моего отца
it's unusual for him to get up early|для него необычно рано вставать
I have a dog|у меня есть собака
your dress is very nice|твое платье очень хорошее
this is my dog|это моя собака
now stop crying|теперь перестань плакать
I have a suggestion|У меня есть предложение
my homework is nearly complete|моя домашняя работа почти завершена
good students study hard|хорошие студенты много учатся
you made a wise choice|ты сделал мудрый выбор
take good care of yourself|береги себя
take good care of yourself|береги себя
take a good care of yourself|береги себя
I'm not always at home on Sundays|Я не всегда дома по воскресеньям
the airplane soon went out of sight|самолет вскоре скрылся из виду
he is said to be a good doctor|он считается хорошим врачом
what is the difference between a and B|в чем разница между а и б
English is easy to learn|Английский легко выучить
I have been studying for two hours|Я учился два часа
I have to iron my shirt|Мне нужно погладить рубашку
don't ask me for money|не проси у меня денег
he's always been kind to me|он всегда был добр ко мне
a piano is expensive|пианино дорого
that kind of dress is now in fashion|такое платье сейчас в моде
wash your hands well|хорошо вымойте руки
I ate a hamburger and ordered another|Я съел гамбургер и заказал еще
your bike is better than mine|твой байк лучше моего
please open the window|пожалуйста, откройте окно
I need to get some sleep|Мне нужно немного поспать
it doesn't matter where he comes from|неважно откуда он
who is your teacher|кто твой учитель
obviously he is wrong|очевидно он неправ
her face turned red|ее лицо покраснело
I object to her going there alone|Я против, чтобы она пошла туда одна
I am accustomed to cold weather|Я привык к холоду
I have an idea|у меня есть идея
he loves her|он любит ее
I'm too busy to help him|Я слишком занят, чтобы помочь ему
answer the phone|ответь на звонок
it's very hot here|Здесь очень жарко
I haven't finished my homework yet|Я еще не закончил домашнее задание
I fell in love with her at first sight|Я влюбился в нее с первого взгляда
a strong wind was blowing|дул сильный ветер
what would happen|что случилось бы
the meeting in short was a waste of time|Короче говоря, встреча была пустой тратой времени
he writes books|он пишет книги
when did you see them first|когда ты их впервые увидел
she traveled all over the world|она путешествовала по всему миру
he can swim well|он может хорошо плавать
my uncle gave me a camera|мой дядя дал мне фотоаппарат
may I try it on|Можно это примерить
I hope that you will get well soon|Я надеюсь что ты скоро поправишься
that's his specialty|это его специальность
how unlucky I am|как мне не повезло
he wakes up early|он просыпается рано
did you telephone him|ты позвонил ему?
I felt like crying|Мне хотелось плакать
does this bus go to the beach|этот автобус идет на пляж
he decided to go abroad|он решил уехать за границу
I am counting on you|Я рассчитываю на тебя
I'll wait for you|Я буду ждать тебя
may I ask you something|можно вас спросить о чем-то
are you busy now|ты сейчас занят
the food is getting cold|еда остывает
I have many friends in foreign countries|У меня много друзей в зарубежных странах
he has a passive character|у него пассивный характер
this hat is mine|эта шляпа моя
my work is finished|моя работа закончена
which do you prefer apples or bananas|какие вы предпочитаете яблоки или бананы
I'll call you later today|Я позвоню тебе сегодня позже
I can't check my mail because the server is down|Я не могу проверить свою почту, потому что сервер не работает
I'm terribly sorry|Мне ужасно жаль
don't forget to write to me|не забудь написать мне
Tom wants to go to Japan|Том хочет поехать в Японию
I can't go nor do I want to|Я не могу идти и не хочу
I need some paper|Мне нужна бумага
please take care of yourself|пожалуйста позаботьтесь о себе
he's very angry with you|он очень зол на тебя
tell me the story|Расскажи мне историю
I stayed up late last night|Я не спал вчера поздно вечером
I don't like this watch|Мне не нравятся эти часы
is it hard to speak English|трудно говорить по английски
you have made the very same mistake again|ты снова сделал ту же ошибку
these books are ours|эти книги наши
keep this money for me|оставь эти деньги для меня
prices have jumped|цены подскочили
you look pale|вы выглядите бледным
we depend on you|мы зависим от тебя
this book is yours|эта книга твоя
it was a great shock to me|для меня это было большим шоком
plants died without water|растения погибли без воды
were you at home last night|вы были дома прошлой ночью
I can't help crying|Я не могу удержаться от слез
they have two daughters|у них есть две дочери
a driver was sleeping in the car|водитель спал в машине
I shouldn't have gotten up so early|Я не должен был вставать так рано
whose pencil is this|чей это карандаш
I like your car|Мне нравится твоя машина
I can't stand the noise|Я терпеть не могу шум
I wanted red shoes|Я хотел красные туфли
they are not interested in saving money|они не заинтересованы в экономии денег
this is their house|это их дом
you were wrong after all|в конце концов, ты был неправ
I think so|я думаю так
this book is not for sale|эта книга не продается
he knocked his knee against the chair|он ударился коленом о стул
have you called her yet|ты уже звонил ей?
when I came home John was studying|когда я пришел домой, Джон учился
this shirt is too small for me to wear|эта рубашка слишком мала для меня, чтобы носить
it snowed in Osaka|в Осаке пошел снег
have you ever been to Africa|ты когда-нибудь был в Африке
how embarrassing|как неловко
what are you waiting for|чего ты ждешь
I am tied up at the office|Я привязан в офисе
you must pay attention to him|ты должен обратить на него внимание
Mary can dance well|Мэри умеет хорошо танцевать
how much is this tie|сколько стоит этот галстук
let's split the bill|Давайте заплатим пополам
we have few opportunities to speak German|у нас мало возможностей говорить по-немецки
Tom likes to play baseball|Том любит играть в бейсбол
he is crazy about baseball|он без ума от бейсбола
I am going to buy a new car|Я собираюсь купить новую машину
can you pick me up at the station|можешь забрать меня на вокзале
he ran out of money|у него кончились деньги
it'll snow tomorrow|завтра будет снег
how's the weather in New York|как погода в Нью-Йорке
what do you usually do on Sundays|что ты обычно делаешь по воскресеньям
this problem is difficult to solve|эту проблему сложно решить
the plane flew over the mountain|самолет пролетел над горой
he came back from America|он вернулся из Америки
he is taking a walk|он гуляет
please lend me your car|пожалуйста, одолжите мне свою машину
when does it end|когда это закончится
she went home|она пошла домой
how long will you stay here|Как долго вы пробудете здесь
who painted these pictures|кто нарисовал эти картины
do you have some time|у тебя есть время
does this hurt|это больно
have you ever seen a kangaroo|вы когда-нибудь видели кенгуру
I hurt my elbow|Я повредил локоть
he has been studying for two hours|он учился два часа
are you free this afternoon|ты свободен сегодня днем?
our children like dogs but I prefer cats|наши дети любят собак, но я предпочитаю кошек
the kid got hurt|ребенок пострадал
tell me about it|Расскажи мне об этом
we have made friends with Tom|мы подружились с Томом
he usually gets up at 6:00|он обычно встает в 6:00
you'd better not go there|тебе лучше не идти туда
let me handle this|Позвольте мне справиться с этой
it's not my fault|это не моя вина
keep an eye on the bags|следи за сумками
she looks very lovely|она выглядит очень мило
there is no meat left in the fridge|в холодильнике не осталось мяса
put this sentence into English|переведите это предложение на английский
are you new here|Ты здесь новенький
tomorrow is my day off|завтра мой выходной
I can read Spanish easily|Я легко могу читать по-испански
my headache has gone|моя головная боль ушла
we thought that you were married|мы думали, что ты женат
he advised her to stop drinking|он посоветовал ей бросить пить
I'll call again later|Я позвоню еще раз позже
do you smoke|вы курите
he entered my room without permission|он вошел в мою комнату без разрешения
the pain was terrible|боль была ужасной
I belong to the swimming club|Я принадлежу к плавательному клубу
this novel is difficult to understand|этот роман трудно понять
I hope you're having fun|Я надеюсь тебе весело
she wears a lot of makeup|она носит много косметики
please come to my house|пожалуйста, приходи ко мне домой
he carried a bag full of apples|он нес сумку, полную яблок
he knows nothing about the plan|он ничего не знает о плане
are they Japanese|они японцы
I'm tired now|Я устал
my car was stolen last night|мою машину украли прошлой ночью
I had all my clothes washed by my mother|Мать стирала всю мою одежду
where is the end of this line|где конец этой строки
I want some water|я хочу немного воды
Tom finally gave up smoking|Том наконец бросил курить
I like neither of them|Мне не нравится ни один из них
I'm proud of you|Я горжусь тобой
I looked for the key|Я искал ключ
he ran as fast as he could|он бежал так быстро, как мог
he was busy yesterday afternoon|он был занят вчера днем
she is awkward|она неловкая
you will stay at home|ты останешься дома
I am sixteen years old|мне шестнадцать лет
I visited the village where he was born|Я побывал в деревне где он родился
hey where are you going|эй куда ты идешь
you can go if you want to|ты можешь пойти, если хочешь
how did you make it|Как вы сделали это
due to bad weather the plane was late|из-за непогоды самолет опоздал
I will give it to you|Я дам это тебе
I usually walk to school|Я обычно хожу в школу
could you sign here|не могли бы вы подписаться здесь
would you like another Apple|хочешь еще одно яблоко
prices continue to rise|цены продолжают расти
don't change your mind|не передумай
close your eyes please|закрой глаза пожалуйста
as a matter of fact it is true|на самом деле это правда
I don't know if she will come|Я не знаю придет ли она
Hey what happened|Эй, что случилось
I want a tie to go with this suit|Я хочу галстук к этому костюму
are you coming with me|ты идешь со мной
I was busy all day|Я был занят весь день
he has got a good camera|у него хорошая камера
visitors may not feed the animals|посетители не могут кормить животных
I can do it in half the time|Я могу сделать это вдвое быстрее
they are all the same|они все одинаковые
he owes his success to his parents|он обязан своим успехом своим родителям
my sister is shorter than you|моя сестра ниже тебя
I envy him|я ему завидую
is there a supermarket near here|есть ли поблизости супермаркет
I failed the tests|Я провалила тесты
I was not as strong as my father|Я был не таким сильным, как мой отец
will you help me with my homework|ты поможешь мне с моей домашней работой
I persuaded him to take part in it|Я уговорил его принять в этом участие
he grows rice|он выращивает рис
he painted the ceiling blue|он покрасил потолок в синий цвет
let's take a break|давай возьмем перерыв
this is an automatic door|это автоматическая дверь
this bus can hold 50 people|этот автобус вмещает 50 человек
I have to go now|сейчас я должен идти
the train was crowded|поезд был переполнен
Tom was sick in bed last Sunday|Том был болен в постели в прошлое воскресенье
what a beautiful flower|какой красивый цветок
I wanted to talk to you I wanted|Я хотел поговорить с тобой я хотел
let's me go alone|давай я пойду одна
do you have one|у тебя есть
he stopped the car|он остановил машину
I fell asleep before my father came home|Я заснул до того, как мой отец вернулся домой
I need first aid|Мне нужна первая помощь
hold on to the rope|держись за веревку
where's the restroom|где туалет
has the movie started yet|фильм еще не начался
he uses honey instead of sugar|он использует мед вместо сахара
the policeman was off-duty|полицейский был вне дежурства
she is good at speaking English|она хорошо говорит по-английски
I can ride a horse|Я могу ездить на лошади
he was standing|он стоял
it seems warm outside|снаружи кажется тепло
Asia is much larger than Australia|Азия намного больше Австралии
follow his example|следовать его примеру
please follow me|пожалуйста следуйте за мной
that shop has many customers|у этого магазина много клиентов
I have a pretty dog|У меня красивая собака
I listen to the radio every night|Я слушаю радио каждую ночь
all of us were silent|все мы молчали
she is about to leave|она собирается уйти
the shop was closed when I went there|магазин был закрыт, когда я пошел туда
please answer the phone|пожалуйста ответь на телефон
she'll do it in 24 hours|она сделает это за 24 часа
I have a bad headache|У меня сильная головная боль
you must keep your room clean|ты должен содержать свою комнату в чистоте
these grapes are ripe|этот виноград спелый
I'm glad you enjoyed it|Я рад, что тебе понравилось
I am happy|Я счастлив
the sooner the better|чем скорее, тем лучше
it's a pity that you can't come|жаль что ты не можешь прийти
is he right|он прав
he is popular among us|он популярен среди нас
I got acquainted with her in France|Я познакомился с ней во Франции
he is capable of teaching French|он может преподавать французский
nobody can break his record|никто не может побить его рекорд
I went hiking|Я пошел в поход
I'd like to see you again next week|Я бы хотел увидеть тебя снова на следующей неделе
he described the scene in detail|он подробно описал сцену
come and see me|приходи ко мне
excuse me who are you|Извините, кто вы
she reluctantly went by herself|она неохотно пошла одна
wait for a moment outside the room|подожди минутку за пределами комнаты
we had lunch at noon|мы обедали в полдень
it was a dark night|это была темная ночь
I wish I earned more money|Я бы хотел заработать больше денег
I have no money to buy the dictionary|У меня нет денег, чтобы купить словарь
it may rain tomorrow|завтра может пойти дождь
have you ever seen Tokyo Tower|Вы когда-нибудь видели Токийскую башню?
please close the door quietly|пожалуйста, закрой дверь тихо
my brother works in a bank|мой брат работает в банке
it's secret|это секрет
can you help me|Вы можете помочь мне
she rejected my proposal|она отклонила мое предложение
I will be here from Monday to Thursday|Я буду здесь с понедельника по четверг
she went from London to Paris|она уехала из Лондона в Париж
a majority voted against the bill|большинство проголосовало против законопроекта
they visit us from time to time|они посещают нас время от времени
he often makes people angry|он часто злит людей
I regret having said so|Я сожалею, что сказал это
is this your first trip abroad|это твоя первая поездка за границу?
they greeted me with a smile|они приветствовали меня с улыбкой
I guess that she is 40|Я думаю что ей 40
he stopped to talk to them|он остановился поговорить с ними
she spoke as though nothing had happened|она говорила так, как будто ничего не произошло
she is practicing the violin now|она сейчас занимается на скрипке
they are pretty|они красивые
you should follow your doctor's advice|вы должны следовать совету вашего врача
this song is very popular in Japan|эта песня очень популярна в Японии
it is very cold today isn't it|сегодня очень холодно, не так ли
she told me she knew my brother|она сказала мне, что знает моего брата
those are their books|это их книги
I don't know where my watch is|Я не знаю где мои часы
no one could solve the problem|никто не мог решить проблему
thank you for today|спасибо за сегодня
hi how are you|Привет, как ты
my dream is to be a firefighter|моя мечта быть пожарным
were you out last night|ты не был вчера вечером
my father's hobby is fishing|хобби моего отца - рыбалка
I saw a cat running after the dog|Я видел, как кошка бежит за собакой
see if the gas is turned off|посмотреть, выключен ли газ
this table is reserved|эта таблица зарезервирована
nothing is missing|ничего не пропало
everybody loves music|все любят музыку
it tasted sweet|это было сладко на вкус
I've met him on several occasions|Я встречал его несколько раз
I can understand him perfectly|Я прекрасно понимаю его
this is Mary's dog|это собака Мэри
you may go there|ты можешь пойти туда
your dog always barks at me|твоя собака всегда лает на меня
what do you do|чем ты занимаешься
you have a little fever today don't you|у тебя сегодня небольшая температура, не так ли
I'd like to send this package to Japan|Я хочу отправить эту посылку в Японию
he comes back from Sydney today|он возвращается из Сиднея сегодня
those books are mine|эти книги мои
we will never agree|мы никогда не согласимся
the dog walked across the street|собака перешла улицу
when would it be convenient for you|когда вам будет удобно
wouldn't you like another glass of beer|не хочешь ли ты еще стакан пива
the knife is not sharp|нож не острый
don't make a mistake|не делай ошибки
the dog was digging a hole|собака копала яму
when was it built|когда это было построено
he didn't answer my question|он не ответил на мой вопрос
can you come for dinner tonight|можешь прийти сегодня на ужин?
the cat is very cute|кот очень милый
come and help us|приходите и помогите нам
do you know when she will come|ты знаешь когда она придет
what is your address|Какой у Вас адрес
your bath is ready|твоя ванна готова
every student has access to the library|у каждого студента есть доступ к библиотеке
don't spill the beans|не проливайте бобы
he went to a fruit store first|он сначала пошел в магазин фруктов
he was right after all|в конце концов он был прав
have you ever been to Tokyo|ты когда-нибудь был в Токио?
this beer is not cold enough|это пиво недостаточно холодное
where do you want to go|Куда ты хочешь пойти
I'm gaining weight|Я набираю вес
don't drop that Cup|не роняйте эту чашку
I have a tourist visa|У меня туристическая виза
she wants to be a designer|она хочет быть дизайнером
few students knew his name|немногие студенты знали его имя
I hurried in order to catch the first train|Я спешил, чтобы успеть на первый поезд
when do you play tennis|когда ты играешь в теннис
I'm learning music|Я учусь музыке
I don't feel like eating out this evening|Я не хочу обедать сегодня вечером
I can swim well|Я умею плавать
he speaks French|он говорит по-французски
that bridge is anything but safe|этот мост совсем не безопасен
I like that young man|Мне нравится этот молодой человек
I didn't take part in the conversation|Я не участвовал в разговоре
would you like me to help you|ты хочешь, чтобы я тебе помог
one of these two answers is right|один из этих двух ответов правильный
he sent a card to Mary|он послал открытку Мэри
I have many things to do|У меня много дел
I'd like to call my parents|Я бы хотел позвонить своим родителям
I'll be back in a wink|Я скоро вернусь
he explained the matter to me|он объяснил мне дело
I don't like coffee|Я не люблю кофе
the school is two kilometres ahead|школа в двух километрах впереди
can you run fast|ты можешь бежать быстро
he was sitting between Mary and Tom|он сидел между Мэри и Томом
it's your turn to sing|твоя очередь петь
these products are selling like hotcakes|эти продукты продаются как горячие пирожки
I didn't go to school last month|Я не ходил в школу в прошлом месяце
let's have lunch|давай пообедаем
I'm still busy|Я по-прежнему занят
don't be so angry|не злись так
we found out where he lives|мы узнали где он живет
bread is made from wheat|хлеб сделан из пшеницы
his aim is to become a doctor|его цель стать врачом
may I go to the movies tonight|могу я пойти в кино сегодня вечером
he is trusted by his parents|ему доверяют его родители
I quit smoking two years ago|Я бросил курить два года назад
he was born in Africa|он родился в Африке
this bridge was built two years ago|этот мост был построен два года назад
I asked him to start at once|Я попросил его начать сразу
we moved into a new house|мы переехали в новый дом
why were you absent yesterday|почему ты отсутствовал вчера
I wish I had a house of my own|Хотел бы я иметь собственный дом
I would like to eat sushi|Я бы хотел съесть суши
this blouse is cotton|эта блузка хлопковая
tell me what you want|скажите, что вы хотите
I don't like her|Она мне не нравится
I will do it myself|Я сделаю это сам
she has been absent from school for five days|она отсутствовала в школе пять дней
I speak a little Japanese|Я немного говорю по-японски
this is the biggest cat that I've ever seen|это самая большая кошка, которую я когда-либо видел
I'll do my best|Я сделаю все возможное
would you please turn down the TV|не могли бы вы выключить телевизор
how old is your grandfather|Сколько лет твоему дедушке
a turkey is a little bigger than a chicken|индейка немного больше курицы
do as you like|делай как хочешь
all our plans went wrong|все наши планы пошли не так
how's business|как бизнес
one is the name of that River|одно имя той реки
she follows her brother wherever he goes|она следует за своим братом, куда бы он ни пошел
he ran into the room|он побежал в комнату
he ran into|он столкнулся с
I had lost my pen|Я потерял ручку
the box is made of wood|шкатулка из дерева
what is in this box|что в этой коробке
he knows a lot about animals|он много знает о животных
she adores cats she adores|она обожает кошек она обожает
whose bag is this|чья это сумка
what are you going to do|чем ты планируешь заняться
the milk tastes sour|молоко кислое на вкус
it is going to rain this afternoon|сегодня днем ​​будет дождь
my little brother can read English|мой младший брат может читать по английски
I can't lift my right arm|Я не могу поднять правую руку
sugar dissolves in water|сахар растворяется в воде
I felt hungry|Я проголодался
Tom goes to school on foot|Том идет в школу пешком
I told him to come|Я сказал ему прийти
we lost the game|мы проиграли
don't turn off the light|не выключай свет
let's finish it right away|давай закончим это прямо сейчас
you like English don't you|тебе нравится английский, не так ли?
will you show me your photo album|вы покажете мне свой фотоальбом
this is what I was waiting for|это то, чего я ждал
it is Monday today|сегодня понедельник
not all of us can speak English|не все из нас могут говорить по-английски
something's wrong with my email|что-то не так с моей электронной почтой
you must study hard|ты должен усердно учиться
I want to send this letter to Japan|Я хочу отправить это письмо в Японию
many of us were tired|многие из нас устали
I can't swim|Я не умею плавать
you are no younger than I am|ты не моложе меня
few people can speak a foreign language perfectly|мало кто может в совершенстве говорить на иностранном языке
he overcame many difficulties|он преодолел множество трудностей
I'm not a student|Я не студент
why do you say that|Почему ты это сказал
you look pale today|ты выглядишь бледным сегодня
they went to the zoo by bus yesterday|вчера они ехали в зоопарк на автобусе
the box is almost empty|коробка почти пуста
how many books do you have|сколько у тебя книг
she has a daughter who is a pianist|у нее есть дочь, которая пианистка
I helped her wash dishes|Я помогал ей мыть посуду
name and address please|имя и адрес пожалуйста
he is a good violinist|он хороший скрипач
he plays golf on weekends|он играет в гольф по выходным
everybody wants to be happy|все хотят быть счастливыми
I'm planning to study tonight|Я планирую учиться сегодня вечером
what do you have|что у тебя есть
the break didn't work|перерыв не сработал
the telephone rang several times|телефон звонил несколько раз
I am beginning to remember it|Я начинаю вспоминать это
I felt very happy|Я был очень счастлив
I raised my hand to ask a question|Я поднял руку, чтобы задать вопрос
what are you doing|что ты делаешь
I neither smoke nor drink|Я не курю и не пью
my house is big|мой дом большой
he does not know English much less French|он не знает английского намного меньше французского
I belong to the baseball team|Я принадлежу к бейсбольной команде
I want to marry you|Я хочу жениться на тебе
we have had plenty of snow this year|у нас было много снега в этом году
please make the bed|пожалуйста, заправь кровать
my room faces east|моя комната выходит на восток
I have a headache|У меня болит голова
the girl's eyes were filled with tears|глаза девушки наполнились слезами
my money was stolen|мои деньги были украдены
he seems honest|он кажется честным
how did you come to know each other|как вы узнали друг друга
her books sell pretty well|ее книги продаются довольно хорошо
his English is quite good|его английский неплохой
there is a fork missing|отсутствует вилка
he lives next to me|он живет рядом со мной
all the flowers in the garden are yellow|все цветы в саду желтые
they live downstairs|они живут внизу
I'd like to see your sister|Я бы хотел увидеть твою сестру
nothing remained in the refrigerator|в холодильнике ничего не осталось
keep your room clean|держи свою комнату в чистоте
it seems to me that he is honest|мне кажется что он честный
she is carrying a backpack on her back|она несет рюкзак на спине
I awoke from a dream|Я проснулся от сна
a mosquito just bit me|меня только что укусил комар
he was elected president|он был избран президентом
no news is good news|отсутствие новостей - хорошая новость
a horse runs quickly|лошадь бежит быстро
since I was thirsty I drank water|так как я хотел пить, я пил воду
I'm not in favor of such a plan|Я не за такой план
he laughed in spite of himself|он рассмеялся невольно
we will keep it for you until you leave|мы сохраним это для вас, пока вы не уйдете
I can't stop laughing|Я не могу перестать смеяться
I have a black and white dog|У меня есть черно-белая собака
I mean no harm|Я не имею в виду никакого вреда
she got up at 7:00 in the morning|она встала в 7 утра
you left your lights on|ты оставил свой свет включенным
he is a kind boy|он добрый мальчик
I'll be absent tomorrow|Я буду отсутствовать завтра
she decided not to attend the meeting|она решила не присутствовать на встрече
what are you interested in|чем ты интересуешься
  
  